111111
100E01
100C01
1P0001
111111