11111111111111111111111
101110000000E0001001001
10000001111000000000001
1P00010C001011001111001
1000000100010100C001001
11110000C00011000111001
10001000000C00000001101
10000000001110000111101
11110000111111000000001
10000001111111100000001
10000000111111000000001
10000000011110000000111
10000000011110000000001
10000000011110000000001
11111100011110000000001
10000000011110001111001
100111000111100000C0001
10000000011110000000001
10000C00011110000000001
10000111011110111000001
10001111111111111100001
10011111111111111110001
10001111111111111110001
10001111110001111110001
10000111100000111100001
10000000000C00000001101
11111111111111111111111