111111
1E0001
100C01
1P0C01
111111