11111111111111111111111
10000000001110000111101
11110C001111110000C0001
10000001111111100E00001
10C00000000000000000001
1000000C0000000000C0111
1000E0000111100000P0001
10P0000001111000C000001
11111111111111111111111