11111111111111
101110000000E1
10000001111011
1P00010C001011
11111111111111