11111111111111111111111
101110000000E0001001001
10000001111000000000001
1P00010C001011001111001
10001000000C00000001101
10000000001110000111101
11110000111111000000001
10000001111111100E00001
10000000111111000000001
10000000011110000000111
1000E0000111100000P0001
10P00000011110000000001
10000C00011110000000001
10000111011110111000001
10001111111111111100001
10011111111111111110001
10001111111111111110001
10001111110001111110001
10000111100000111100001
10E00000000C00000001101
11111111111111111111111